; My levels!


#######
#     #
# @ $.#
#     #
#     #
#######

#######
#  @  #
#     #
#  $  #
#  .  #
#  .  #
#  $  #
#     #
#######

#######
#  @  #
# # # #
# $ $ #
###.###
  #.#
  ###
